111111111111111
10000000C010001
100E00100001101
1000000C0010011
1C0000000000P01
111111111111111
