11111111111111111111111111111111
100000000000000C00000C0000000001
10100101001000001010010000010101
1010010010101010001001000E010101
1P0000000C00C00000000000000000C1
10000000001110001111111110000101
11111111111111111111111111111111
