1111111111
11001110E1
100C00C101
1001000001
1P010C1111
1111111111
