111111111111
1E10C01001P1
10101010C101
100010000001
1000000C0001
111111111111
