111111111111111
1100001111100E1
100100C0000C101
100100000000001
1P010C110000011
111111111111111
