11111111111111111111111
11110000111001100C000E1
1C0110000C000000100C101
10000010000001110000001
1P010C1001000C010000011
11111111000011011C00011
1111111111000C000000011
11111111111111111111111
