111111111111111
10001000C010001
100000100001101
1000000C0010011
1C00000z0000P01
111111111111111
