111111111111
100000000001
1E000P00C001
100000000001
111111111111
